 ### ######### ##### ####### ### ####### 
#...#.........#.....#.......#...#.......#
#.#.#.#.#####.###.#.#######.#.#.#.#####.#
#.#...#...#.......#.........#.#.#...#...#
#.#### ##.######## ######.###.#.###.#.#.#
#.#...#O#...#...#.#.......#...#.....#.#.#
#.#.#.#.###.#.#.#.#.#######.#########.#.#
#.#.#.#...#...#.#...#...........#...#.#.#
#.#.#.#.#.#####.#.###.#######.###.#.#.#.#
#...#...#.#.....#.#...#...#...#...#...#.#
 ### ####.#.#######.###.#.#.###.#######.#
#...#...#.#.......#.#...#.#...#.#.......#
#.#.###.#.#######.#.#.###.#.###.#.#####.#
#.#...#.#.#...#...#.#.#...#.#...#.#...#.#
#.###.#.#.###.#.###.#.#.###.#.###.#.#.## 
#.#.....#.....#.....#.#.#...#.#...#.#...#
#.###.#######.#######.#.#.###.#.###.###.#
#...#.#...#...#...#...#.#.#...#.#...#...#
 ##.###.#.#.#####.#.###.#.#.#####.###.## 
#...#...#...#...#.#.#...#.#.#.......#...#
#.###.#######.#.#.#.###.#.#.#.#########.#
#.....#.......#...#...#.#.#.....#.......#
#.#########.#####.#####.#########.###### 
#.#.........#.......#...#.........#.....#
#.#.###.#####.#######.###.#############.#
#.#.#...#...#.....#...#...#...#.........#
#.#.#.###.#.#####.#.#####.#.###.###.###.#
#.#.#.#...#.#.....#.#.....#.....#...#...#
#.###.#.###.#.#####.#.###########.###.## 
#.....#.#.#.#...#.#...#...........#...#.#
 ######.#.#.###.#.#####.###.#######.###.#
#.#.....#...#...#...#.....#...#...#...#.#
#.#.#.###.###.###.#.#########.#.#####.#.#
#...#...#.#...#...#...#.....#.#.....#.#.#
#.#####.###.#####.###.#.###.#.#.###.#.#.#
#.#...#.....#...#...#.#.#...#.#...#.#...#
#.###.#######.#.###.#.#.###.#.#.###.###.#
#...#.........#...#.#.#...#...#.#.....#.#
 ##.#.###########.#.#.###.#####.#.#####.#
#.....#.............#.....#.....#.......#
 ##### ############# ##### ##### ####### 
